50 50
161 161 161 161 161 161 161 161 161 161 161 161 161 161 161 161 202 170 161 161 161 161 161 161 161 161 161 161 161 161 161 161 161 161 161 161 161 161 161 161 161 161 161 161 161 161 197 161 161 161
161 161 161 161 192 193 193 193 193 193 194 161 162 161 161 161 202 202 170 161 161 161 161 161 161 161 161 161 161 161 161 161 161 161 161 161 161 161 161 161 161 161 161 161 161 161 197 161 161 161
161 161 161 192 160 160 160 160 160 160 225 193 193 194 161 161 202 202 202 170 161 161 161 161 161 161 161 161 161 161 161 161 161 161 161 161 161 161 161 161 161 161 161 161 161 161 171 161 161 161
161 161 192 160 160 160 160 160 160 160 160 160 160 225 193 194 234 202 202 202 170 161 161 161 161 161 161 161 161 161 161 161 161 161 161 161 161 161 161 161 161 161 161 161 161 197 203 161 161 161
161 161 224 160 160 160 160 160 160 160 160 160 160 160 160 226 161 234 202 202 202 170 161 161 161 161 161 161 161 161 161 161 161 161 161 161 161 161 161 161 161 161 161 161 161 197 203 161 161 161
161 161 224 160 160 160 160 160 160 160 160 160 160 160 160 160 194 161 234 202 202 202 170 228 161 161 161 161 161 161 161 161 161 161 161 161 161 161 161 161 161 161 161 161 161 197 203 161 161 161
161 161 224 160 160 160 160 160 160 225 257 257 225 160 160 160 226 161 161 234 202 202 202 169 170 161 161 161 161 161 161 161 161 161 161 161 161 161 161 161 161 161 161 161 161 171 203 161 161 161
161 161 224 160 160 160 160 160 160 226 161 161 256 257 257 257 258 161 161 161 234 202 202 169 202 170 161 161 161 161 161 161 161 161 161 161 161 161 161 161 161 161 161 161 171 203 203 161 161 161
161 161 224 160 160 160 160 160 160 225 194 161 161 161 161 161 161 161 161 161 161 234 202 169 202 202 170 161 161 161 161 161 161 161 161 161 161 161 161 161 161 161 228 171 203 203 203 161 161 161
161 161 256 225 160 160 160 160 160 160 225 194 161 161 161 161 161 161 161 161 161 161 234 201 202 202 202 170 161 161 161 161 161 161 161 161 161 161 161 228 228 171 169 203 203 203 203 161 161 161
161 161 161 224 160 160 160 160 160 160 160 225 194 161 162 161 161 161 161 161 161 161 161 161 234 202 202 202 170 228 228 265 266 267 228 228 228 228 171 169 169 203 169 203 203 203 203 161 161 161
161 161 161 256 257 225 160 160 160 160 160 160 226 161 161 161 161 161 162 161 161 161 161 161 161 234 202 202 202 169 169 265 266 267 169 169 169 169 203 169 169 203 169 203 203 203 235 161 161 161
161 161 161 161 161 256 257 225 160 160 160 160 226 161 161 161 161 161 161 161 161 161 161 161 161 161 234 202 202 169 169 265 266 267 169 169 169 169 203 169 169 203 169 203 203 203 161 161 161 161
161 161 161 162 161 161 161 256 257 257 257 257 258 161 161 161 161 161 161 161 161 161 161 161 161 161 161 234 202 169 169 265 266 267 169 169 169 169 203 169 169 203 169 203 235 165 161 161 161 161
161 161 161 161 161 161 161 161 161 161 161 161 161 161 161 161 161 161 161 161 161 161 161 161 161 161 161 161 234 169 169 265 266 267 169 169 169 169 203 169 169 203 201 235 161 197 161 161 161 161
161 161 161 161 161 161 161 161 162 161 161 161 161 161 161 161 161 161 161 161 161 161 161 161 161 161 161 161 197 169 169 265 266 267 169 169 169 169 203 201 201 235 161 161 161 197 161 161 161 161
161 161 161 161 161 161 161 161 161 161 161 161 161 161 161 161 161 161 161 161 161 161 161 161 161 161 161 161 171 201 233 265 266 267 233 201 201 201 235 161 161 161 161 161 161 197 161 161 161 161
161 161 161 161 161 161 161 161 161 161 161 161 161 161 161 161 161 161 161 161 161 161 161 161 161 161 161 171 235 161 161 265 266 267 161 161 161 161 161 161 161 161 161 161 161 171 161 161 161 161
161 161 161 161 161 161 161 161 161 161 161 161 161 161 161 161 161 161 161 161 161 161 161 161 161 161 171 235 161 161 161 161 161 161 161 161 161 161 161 161 161 161 161 161 197 235 161 161 161 161
170 161 161 161 161 161 161 161 161 161 161 161 161 161 161 161 161 161 161 161 161 161 161 161 228 171 235 161 161 161 161 161 161 161 161 161 161 161 161 161 161 161 161 161 171 161 161 161 161 161
234 170 228 161 161 161 161 161 161 161 161 161 161 161 161 161 161 161 161 161 161 161 161 171 201 235 161 161 161 161 161 161 161 161 161 161 161 161 161 161 161 161 161 197 235 161 161 161 161 161
161 234 202 170 228 228 161 161 161 161 161 161 161 161 161 161 161 161 161 161 161 228 171 235 161 161 161 161 161 161 161 161 161 161 161 161 161 161 161 161 161 161 161 171 161 161 161 161 161 161
161 161 161 234 201 201 170 228 228 228 228 228 228 228 228 228 265 266 267 228 171 201 235 161 161 161 161 161 161 161 161 161 161 161 161 161 161 161 161 161 161 161 197 235 161 161 161 161 161 161
161 161 161 161 161 161 234 201 201 201 201 201 201 201 201 233 265 266 267 233 235 161 161 161 161 161 161 161 161 161 161 161 161 161 161 161 161 161 161 161 161 161 171 161 161 161 161 161 161 161
161 161 161 161 161 161 161 161 161 161 161 161 161 161 161 161 161 161 161 161 161 161 161 161 161 161 161 161 161 161 161 161 161 161 161 161 161 161 161 161 161 197 235 161 161 161 161 161 161 161
161 161 161 161 161 161 161 161 161 161 161 161 161 161 161 161 161 161 161 161 161 161 161 161 161 161 161 161 161 161 161 161 161 161 161 161 161 161 161 161 161 171 161 161 161 161 161 161 161 161
161 161 161 161 161 161 161 161 161 161 161 161 161 161 161 161 161 161 161 161 161 161 161 161 161 161 161 161 161 161 161 161 161 161 161 161 161 161 161 161 171 235 161 161 161 161 161 161 161 161
161 161 161 161 161 161 161 161 161 161 161 161 161 161 161 161 161 161 161 161 161 161 161 161 161 161 161 161 161 161 161 161 161 161 161 161 161 161 161 171 235 161 161 161 161 161 161 161 161 161
161 161 161 161 161 161 161 161 161 161 161 161 161 161 161 161 161 161 161 161 161 161 161 161 161 161 161 161 161 161 161 161 161 161 161 161 161 228 171 235 161 161 161 161 161 161 161 161 161 161
161 161 161 161 161 161 161 161 161 161 161 161 161 161 161 161 161 161 161 161 161 161 161 161 161 161 161 161 161 161 161 161 161 161 161 161 171 201 235 161 161 161 161 161 161 161 161 161 161 161
161 161 161 161 161 161 161 161 161 161 161 161 161 161 161 161 161 161 161 161 161 161 161 161 161 161 161 161 161 161 161 161 161 161 228 171 235 161 161 161 161 161 161 161 161 161 161 161 161 161
161 161 161 161 161 161 161 161 161 161 161 161 161 161 161 161 161 161 161 161 161 161 161 161 161 161 161 161 161 161 161 161 161 171 201 235 161 161 161 161 161 161 161 161 161 161 161 161 161 161
161 161 161 161 161 161 161 161 161 161 161 161 161 161 161 161 161 161 161 161 161 161 161 161 161 161 161 161 161 161 228 228 171 235 161 161 161 161 161 176 176 176 176 161 161 161 161 161 161 161
170 228 228 228 228 228 228 161 161 161 161 161 161 161 161 161 161 161 161 161 161 161 161 161 228 228 228 228 228 171 201 201 235 161 161 161 161 176 173 173 173 173 173 173 176 176 161 161 161 161
234 201 201 201 201 201 201 170 228 228 265 267 228 228 228 228 228 228 228 228 228 228 228 171 201 201 201 201 201 235 161 161 161 161 176 176 173 173 173 173 173 173 173 173 173 173 173 161 161 161
161 161 161 161 161 161 161 234 201 233 265 267 233 201 201 201 201 201 201 201 201 201 201 235 161 161 161 161 161 161 161 161 161 173 173 173 173 173 173 173 174 173 173 173 173 173 173 173 161 161
161 161 161 161 161 161 161 161 161 161 161 161 161 161 161 161 161 161 161 161 161 161 161 161 161 161 161 161 175 176 176 176 207 173 173 173 173 173 173 173 173 173 173 173 173 173 173 173 209 173
161 161 161 161 161 161 161 161 161 161 161 161 161 161 161 161 161 161 161 161 161 161 161 175 176 176 176 176 173 173 173 173 173 173 173 173 173 173 173 173 173 173 173 173 173 173 173 173 209 173
161 161 161 161 161 161 161 161 161 161 161 161 161 175 176 176 176 176 176 176 176 176 176 173 173 173 173 173 173 173 173 173 173 173 173 173 173 173 173 173 173 173 173 173 173 173 173 173 209 173
161 161 161 161 161 161 161 161 161 161 161 161 175 173 173 173 172 173 173 173 173 173 173 173 173 173 173 172 173 173 207 173 173 173 173 173 174 173 173 173 173 173 173 173 173 173 173 173 209 173
161 161 161 161 161 161 161 161 161 161 161 161 207 173 173 173 173 173 173 173 173 173 173 173 173 173 173 173 173 173 207 173 173 173 173 173 173 173 173 173 173 173 173 173 173 173 173 174 209 173
161 161 161 161 161 161 161 161 161 161 161 161 207 173 173 173 173 173 173 173 173 173 173 173 173 173 173 173 173 173 207 173 173 173 173 173 173 173 173 173 173 173 173 173 173 173 173 173 209 173
161 161 161 161 161 161 161 161 161 161 161 161 239 173 173 173 173 173 173 173 172 173 173 173 173 173 173 173 173 173 178 173 173 173 173 173 173 173 173 173 173 173 173 174 173 173 173 173 179 173
161 161 161 161 161 161 161 161 161 161 161 161 161 239 173 173 173 173 173 173 173 173 173 173 173 174 173 173 173 173 210 178 173 173 173 173 173 173 173 173 173 173 173 173 173 240 240 179 211 173
161 161 161 161 161 161 161 161 161 161 161 161 161 161 239 274 276 173 173 173 173 173 173 173 173 173 173 173 173 173 242 210 178 240 240 240 173 173 173 173 173 173 240 240 179 180 180 211 243 173
161 161 161 161 161 161 161 161 161 161 161 161 161 161 161 274 276 239 240 173 173 173 173 173 173 173 173 173 173 173 173 242 210 180 180 180 178 240 274 276 240 179 180 180 211 212 212 243 173 173
161 161 161 161 161 161 161 161 161 161 161 161 161 161 161 161 161 161 161 239 173 173 173 173 173 173 173 173 173 173 173 173 242 212 212 212 210 180 274 276 180 211 212 212 243 173 173 173 173 173
161 161 161 161 161 161 161 161 161 161 161 161 161 161 161 161 161 161 161 161 207 173 173 172 173 173 173 173 172 173 173 173 173 173 173 173 242 212 274 276 212 243 173 173 173 173 173 173 173 173
161 161 161 161 161 161 161 161 161 161 161 161 161 161 161 161 161 161 161 161 207 173 173 173 173 173 173 173 173 173 173 173 173 173 173 173 173 173 274 276 173 173 173 173 173 173 173 173 173 173
161 161 161 161 161 161 161 161 161 161 161 161 161 161 161 161 161 161 161 161 207 173 173 173 173 173 173 173 173 173 173 173 173 173 173 173 173 173 173 173 173 173 173 173 173 173 173 173 173 173