50 50
12 699 131 701 12 81 17 17 17 17 17 17 17 17 17 83 12 12 354 12 12 12 12 12 12 43 44 44 45 12 12 12 12 699 700 700 700 700 700 700 700 700 700 700 700 700 700 700 700 700
12 699 131 701 12 81 17 17 17 17 17 17 17 17 17 115 16 353 354 12 12 12 12 12 43 13 76 76 13 45 12 12 12 699 700 700 700 700 700 700 700 700 700 700 700 700 700 700 700 700
12 699 131 701 12 113 114 114 114 82 17 17 17 17 115 12 12 353 136 12 12 12 12 12 75 76 76 76 76 13 45 12 12 731 637 700 700 700 700 700 700 700 700 700 700 700 700 700 700 700
12 699 131 701 16 12 12 12 12 113 82 17 17 115 12 16 385 136 199 12 12 12 12 12 75 76 76 76 76 76 13 45 12 12 699 700 700 700 700 700 700 700 700 700 700 700 700 700 700 700
12 699 131 701 12 12 12 16 12 12 81 17 115 12 353 136 330 199 199 12 12 12 12 12 107 13 76 76 76 76 76 77 12 12 731 637 700 700 700 700 700 700 700 700 700 700 700 700 700 700
12 699 131 701 12 12 12 12 353 49 17 83 353 385 136 199 330 199 142 12 12 12 12 12 12 107 13 76 76 76 76 77 12 12 12 731 637 700 700 700 700 700 700 700 700 700 700 700 700 700
12 699 131 701 12 12 12 12 353 262 263 264 136 330 199 142 354 142 12 12 12 12 12 12 12 12 75 76 76 76 76 77 12 12 12 12 699 700 700 700 700 700 700 700 700 700 700 700 700 700
385 699 131 701 385 385 385 385 136 262 263 264 199 330 142 353 136 12 12 12 12 12 12 12 12 12 75 76 76 76 13 77 12 12 12 12 699 700 700 700 700 700 700 700 700 700 700 700 700 700
298 128 128 128 298 298 298 298 199 262 263 264 142 12 353 136 142 12 12 12 12 12 12 12 12 12 107 13 76 13 109 12 12 12 12 12 699 700 700 700 700 66 700 700 66 700 700 700 700 700
298 128 128 128 298 298 298 298 142 81 82 83 12 16 354 142 12 12 12 12 12 12 12 12 12 12 12 107 108 109 12 12 12 12 12 12 699 700 700 700 700 700 700 700 700 700 66 700 66 700
12 699 131 701 12 12 12 12 49 82 114 115 353 385 136 12 12 12 12 12 12 12 49 50 50 51 12 12 12 12 12 12 12 12 12 12 699 700 700 700 700 700 700 700 66 700 700 700 700 700
12 699 131 701 12 12 49 50 82 115 353 385 136 330 142 12 12 12 12 12 12 49 82 82 82 115 12 12 12 12 12 12 12 12 12 667 637 700 700 700 700 66 700 700 131 5 5 5 5 5
385 699 131 701 385 385 262 263 264 385 136 330 142 12 12 12 12 12 12 12 49 82 82 82 115 12 12 12 12 12 12 12 12 12 667 637 700 700 700 700 700 700 131 5 2 2 2 2 2 2
330 128 128 128 330 330 262 263 264 330 142 12 12 12 12 12 12 12 12 49 82 82 82 115 12 12 12 12 12 12 12 12 12 667 637 700 700 700 66 700 700 131 2 2 2 2 2 2 2 37
12 699 131 701 12 12 113 82 82 51 12 12 12 12 12 12 12 49 50 82 82 82 115 12 12 12 12 12 12 12 667 668 668 637 700 700 700 700 700 700 131 2 2 2 2 2 2 2 2 2
12 699 131 701 12 12 12 81 82 82 51 12 12 12 49 50 50 82 82 82 82 115 12 12 12 12 12 12 12 667 637 700 700 700 700 700 700 700 700 131 2 2 2 71 2 2 2 2 2 2
12 699 131 701 12 12 12 113 82 82 82 50 50 50 82 82 82 82 82 82 115 12 12 12 12 12 12 12 667 637 700 700 700 700 700 700 700 66 700 36 2 2 2 2 2 2 2 2 2 2
12 699 131 701 12 12 12 12 113 82 82 82 82 82 82 82 82 82 82 115 12 12 12 12 12 12 12 667 637 700 700 700 700 700 700 700 700 700 700 36 2 2 2 2 2 2 2 2 2 2
12 699 131 701 12 12 12 12 12 113 114 82 82 82 82 82 82 82 115 12 12 12 12 12 12 12 667 637 700 700 700 700 700 700 700 66 700 66 700 36 2 2 2 2 2 2 2 2 2 2
668 637 131 637 669 12 12 12 12 12 12 113 114 82 82 82 82 83 12 12 12 12 12 12 12 667 637 700 700 700 700 700 700 66 700 700 700 700 66 8 2 37 2 2 2 2 2 2 2 2
700 700 700 700 637 669 12 12 12 12 12 12 12 81 82 82 82 83 12 12 12 12 12 12 667 637 700 700 700 700 700 700 700 700 700 66 66 66 66 40 8 69 2 2 2 2 2 2 2 2
700 700 700 700 700 637 669 12 12 12 12 12 12 81 82 82 82 83 12 12 12 12 12 667 637 700 700 700 700 700 700 700 700 66 66 66 66 66 66 40 40 101 8 69 2 2 37 2 2 2
700 700 700 700 700 700 637 669 12 12 12 12 12 113 82 82 82 83 12 12 12 12 667 637 700 700 700 700 700 700 700 700 700 66 66 66 66 66 66 40 40 101 40 101 8 69 69 2 2 2
700 700 700 700 700 700 700 637 669 12 12 12 12 12 81 82 82 83 12 12 12 12 699 700 700 700 700 700 700 700 700 66 700 700 66 66 66 66 99 72 40 101 40 101 40 101 101 8 103 105
700 700 700 700 700 700 700 700 637 669 12 12 12 12 81 82 82 83 12 12 12 12 699 700 700 700 700 700 700 700 700 700 700 700 66 66 66 99 2 2 72 101 40 101 40 101 101 40 103 105
700 700 700 700 700 700 700 700 700 701 12 12 12 12 81 82 82 83 12 12 12 12 699 700 700 700 700 700 700 700 700 700 66 700 700 66 99 2 2 2 2 2 72 101 40 101 101 40 103 105
700 700 700 700 700 700 700 700 700 701 12 12 12 12 81 82 82 82 51 12 12 12 699 700 700 700 700 700 700 700 700 700 700 700 66 99 2 2 2 2 2 2 2 2 72 101 101 40 103 105
700 700 700 700 700 700 700 700 700 637 669 12 12 12 113 82 82 82 82 51 12 12 731 637 700 700 700 700 700 700 637 732 732 732 99 2 2 2 2 2 2 2 2 2 2 2 2 72 103 105
700 700 700 700 700 700 700 700 700 700 637 669 12 12 12 113 114 82 82 82 51 12 12 731 732 732 732 732 732 732 733 12 12 12 119 2 2 2 2 2 2 2 2 2 2 2 2 2 2 2
700 700 700 700 700 700 700 700 700 700 700 637 669 12 12 12 12 113 82 82 82 50 51 12 12 12 12 12 12 12 12 12 12 12 12 119 2 2 2 2 2 2 2 2 2 2 2 2 2 2
700 700 700 700 700 700 700 700 700 700 700 700 701 12 12 12 12 12 113 82 82 82 82 51 12 12 12 12 12 12 12 12 12 12 12 12 87 2 2 2 2 2 2 2 2 2 2 2 2 2
700 700 700 700 700 700 700 700 700 700 700 700 701 12 12 12 12 12 12 113 82 82 82 82 50 50 50 50 51 12 12 12 12 12 12 12 87 2 2 2 2 2 2 2 2 2 2 2 2 2
700 700 700 700 700 700 700 700 700 700 700 700 637 669 12 12 12 12 12 12 113 82 82 82 82 82 82 82 83 12 12 12 12 12 12 12 119 88 2 2 2 2 2 2 2 2 2 2 2 2
700 700 700 700 700 700 700 700 700 700 700 700 700 701 12 12 12 12 12 12 12 113 114 114 82 82 82 82 83 12 12 12 12 12 12 12 12 119 120 120 88 2 2 2 2 2 2 2 2 2
700 700 700 700 700 700 700 700 700 700 700 700 700 701 12 12 12 12 12 12 12 12 12 12 113 114 114 114 115 12 12 12 12 12 12 12 12 12 12 12 119 120 120 120 88 2 2 2 2 2
700 700 700 700 700 700 700 700 700 700 700 700 700 701 12 12 12 12 12 12 12 12 12 12 12 12 12 12 12 12 12 12 12 12 12 12 12 12 12 12 12 12 12 12 119 120 120 120 120 120
700 700 700 700 700 700 700 700 700 700 700 700 700 701 12 12 12 12 12 12 12 12 12 12 12 12 12 12 12 12 12 12 12 12 12 667 668 668 668 668 668 668 668 669 12 12 12 12 12 12
700 700 700 700 700 700 700 700 700 700 700 700 700 701 12 12 12 12 12 12 12 12 12 12 12 12 12 12 12 12 12 12 667 668 668 637 700 700 700 700 700 700 700 637 668 668 668 669 12 12
700 700 700 700 700 700 700 700 700 700 700 700 700 701 12 12 12 12 12 12 12 12 12 12 12 12 12 12 667 668 668 668 637 700 700 700 700 700 700 700 700 700 700 700 700 700 700 637 668 668
700 700 700 700 700 700 700 700 700 700 700 700 700 701 12 12 12 12 12 12 12 12 12 12 12 12 667 668 637 700 700 700 700 700 700 700 700 700 700 700 700 700 700 700 700 700 700 700 700 700
700 700 700 700 700 700 700 700 700 700 637 732 732 733 12 12 12 12 12 12 12 12 12 12 12 667 637 700 700 700 700 700 700 700 700 700 700 700 700 700 700 700 700 700 700 700 700 700 700 700
700 700 700 700 700 700 637 732 732 732 733 12 12 12 12 12 12 12 12 12 12 12 667 668 668 637 700 700 700 700 700 700 700 700 700 700 700 700 700 700 700 700 700 700 700 700 700 700 700 700
732 732 732 732 732 732 733 12 12 12 12 12 12 12 12 12 12 12 12 12 12 667 637 700 700 700 700 700 700 700 700 700 700 700 700 700 700 700 700 700 700 700 700 700 700 700 700 700 700 700
12 12 12 12 12 12 12 12 12 12 12 12 12 12 12 12 12 12 12 667 668 637 700 700 700 700 700 700 700 700 700 700 700 700 700 700 700 700 700 700 700 700 700 700 700 700 700 700 700 700
12 12 12 12 12 12 12 12 12 12 12 12 12 12 12 12 12 667 668 637 700 700 700 700 700 700 700 700 700 700 700 700 700 700 700 700 700 700 700 700 700 700 700 700 700 700 700 700 700 700
12 12 12 12 12 12 12 12 12 12 12 12 12 12 12 667 668 637 700 700 700 700 700 700 700 700 700 700 700 700 700 700 700 700 700 700 700 700 700 700 700 700 700 700 700 700 700 700 700 700
12 12 12 12 12 12 12 12 12 12 12 12 12 12 667 637 700 700 700 700 700 700 700 700 700 700 700 700 700 700 700 700 700 700 700 700 700 700 700 700 700 700 700 700 700 700 700 700 700 700
12 12 12 12 12 12 12 12 12 12 12 12 667 668 637 700 700 700 700 700 700 700 700 700 700 700 700 700 700 700 700 700 700 700 700 700 700 700 700 700 700 700 700 700 700 700 700 700 700 700
12 12 12 12 12 12 12 12 12 12 12 12 699 700 700 700 700 700 700 700 700 700 700 700 700 700 700 700 700 700 700 700 700 700 700 700 700 700 700 700 700 700 700 700 700 700 700 700 700 700
12 12 12 12 12 12 12 12 12 12 12 12 699 700 700 700 700 700 700 700 700 700 700 700 700 700 700 700 700 700 700 700 700 700 700 700 700 700 700 700 700 700 700 700 700 700 700 700 700 700