40 40
301 301 301 301 301 301 301 301 301 301 301 301 301 301 73 73 73 301 301 301 301 301 73 73 301 301 301 301 301 301 301 301 301 301 301 301 301 301 301 301
301 301 301 301 301 301 301 301 301 301 301 301 301 17 103 103 103 16 73 73 73 17 103 103 16 301 301 301 301 301 301 301 301 301 301 301 301 301 301 301
301 301 301 301 301 301 301 301 301 301 301 301 17 47 75 103 103 46 103 103 103 47 103 103 46 16 301 301 301 301 301 301 301 301 301 301 301 301 301 301
301 301 301 301 301 301 301 301 301 301 301 17 47 47 103 103 75 46 103 103 103 47 75 103 46 46 16 301 301 301 301 301 301 301 301 301 301 301 301 301
73 73 73 73 73 73 73 73 73 73 17 47 47 47 103 103 103 46 103 103 103 47 103 103 46 46 46 16 301 301 301 301 301 301 301 301 301 301 301 301
103 103 103 103 103 103 103 103 103 103 47 47 47 47 133 133 133 46 103 103 103 47 133 133 46 46 46 46 16 301 301 301 301 301 301 301 301 301 301 301
103 103 103 103 103 103 103 103 103 103 47 47 47 77 301 301 301 76 133 134 133 77 271 271 76 46 46 46 46 16 301 301 301 301 301 301 301 301 301 301
103 103 103 103 103 103 103 103 103 103 47 47 77 301 301 301 301 301 301 301 301 301 301 301 301 76 46 46 46 46 16 301 301 301 301 301 301 301 301 301
103 103 103 103 103 103 103 103 103 103 47 77 301 301 301 301 301 301 301 301 301 301 301 301 301 301 76 46 46 46 46 16 301 301 301 301 301 301 301 301
272 272 272 272 272 272 272 272 272 44 77 301 301 301 301 273 274 274 274 274 275 301 301 301 301 301 301 76 46 46 46 46 16 73 73 73 73 73 73 73
301 301 301 301 301 301 301 301 301 44 301 301 301 301 301 303 243 243 243 243 305 301 301 301 301 245 301 301 76 46 46 46 46 103 103 103 103 103 103 103
301 301 301 301 301 301 301 301 301 44 301 301 301 301 301 303 243 243 243 243 305 301 301 301 301 301 301 301 301 76 46 46 46 103 103 103 103 103 103 103
301 301 301 301 301 301 301 301 301 44 301 301 301 301 301 303 243 243 243 243 305 301 301 301 301 301 301 301 301 301 76 46 46 103 103 103 103 103 103 103
301 301 301 301 301 301 301 301 301 44 301 301 301 301 301 303 243 243 243 243 305 301 301 301 301 301 301 301 301 301 301 76 46 103 103 103 103 103 103 103
73 73 73 73 106 106 73 73 73 74 301 301 301 301 301 333 334 334 334 334 335 301 301 301 301 301 245 301 301 301 301 301 76 133 133 133 133 133 133 133
103 103 103 103 106 106 103 103 103 104 301 301 301 301 301 301 301 301 301 301 301 301 301 301 301 301 301 301 301 301 301 301 301 301 301 301 301 301 301 301
301 301 301 301 301 301 301 301 301 301 301 301 301 245 301 301 301 301 301 301 301 301 301 301 301 301 301 301 301 301 301 301 301 301 301 301 301 301 301 301
301 301 301 301 301 301 301 301 301 301 301 301 301 301 301 301 301 301 301 301 301 301 301 301 301 301 301 301 301 301 301 43 43 43 43 43 301 301 301 301
301 301 301 301 301 301 301 301 301 301 301 301 301 301 301 301 301 43 301 301 301 301 301 301 301 301 301 301 301 301 301 301 301 43 43 43 301 301 301 301
301 301 301 301 301 301 301 301 301 301 301 301 301 301 301 301 43 43 301 301 301 301 301 301 301 301 301 301 301 301 301 301 301 301 301 301 301 301 301 301
301 301 301 301 301 301 301 301 301 301 301 301 301 301 301 301 43 43 301 301 301 301 301 301 301 301 301 301 301 301 301 301 301 301 301 301 301 301 301 301
301 301 301 301 301 43 43 301 301 301 301 301 301 301 301 301 43 301 301 301 301 301 301 301 301 301 301 301 301 301 301 301 301 301 301 301 301 301 301 301
301 301 301 301 301 43 43 301 301 301 245 301 301 301 301 301 301 301 301 301 301 301 301 43 43 301 301 301 301 301 301 301 301 301 301 301 301 301 301 301
301 301 301 301 301 301 43 301 301 301 245 301 301 301 301 301 301 301 301 301 301 301 301 43 43 301 301 301 301 301 301 301 301 301 301 301 301 301 301 301
301 301 301 301 301 301 43 43 301 301 301 301 301 301 301 301 301 301 301 301 301 301 43 43 301 301 301 301 301 301 301 301 245 301 301 301 301 301 301 301
301 301 301 301 301 301 301 301 301 301 301 301 301 301 301 301 301 301 301 301 301 301 43 43 301 301 301 301 301 301 301 301 301 301 301 301 301 301 245 301
301 301 301 301 301 301 301 301 301 301 301 301 301 301 301 301 301 301 301 301 301 301 43 301 301 301 301 301 301 301 301 301 301 301 301 301 301 301 301 301
301 301 301 301 301 301 301 301 301 301 301 301 301 301 301 43 43 301 301 301 301 301 301 301 301 301 301 301 301 301 301 301 301 301 301 301 301 301 301 301
301 301 301 245 301 301 301 301 301 245 301 301 301 301 301 43 43 301 301 301 301 301 301 301 301 301 301 301 301 301 301 301 301 301 301 301 301 301 301 301
301 301 301 301 301 301 301 301 301 301 301 301 301 301 301 43 43 301 301 301 301 301 301 301 301 301 301 245 301 301 301 43 43 301 301 301 301 301 301 301
301 301 301 301 301 301 301 301 301 301 301 301 301 301 301 301 43 43 301 301 301 301 301 301 301 301 301 301 301 301 301 43 43 43 301 301 301 301 301 301
301 301 301 301 301 301 301 301 301 301 301 301 301 301 301 301 301 43 301 301 301 301 245 301 301 301 301 301 301 301 301 43 43 301 301 301 301 301 301 301
301 301 301 301 301 301 301 301 43 43 43 301 301 301 301 301 301 43 301 301 301 301 301 301 301 301 301 301 301 301 43 43 43 301 301 301 301 301 301 301
301 301 245 301 301 301 301 301 43 43 43 301 301 301 301 301 301 301 301 301 301 301 301 301 301 301 301 301 301 301 43 301 301 301 301 301 301 301 301 301
301 301 301 301 301 301 301 301 301 301 43 301 301 301 301 301 301 301 301 301 301 301 301 301 301 301 301 301 301 301 301 301 301 301 301 301 301 301 301 301
301 301 301 301 301 301 301 301 301 301 301 301 301 301 301 301 301 301 301 301 245 301 301 301 301 301 301 301 301 301 301 301 301 301 301 301 301 245 301 301
301 301 245 301 301 301 301 301 301 245 301 301 301 301 301 301 301 301 301 301 301 301 301 301 301 301 301 301 301 245 301 301 301 301 301 301 301 301 301 301
301 301 301 301 301 301 301 301 301 301 301 301 301 301 301 301 301 301 301 301 301 301 301 301 301 301 301 301 301 301 301 301 301 301 301 301 301 301 301 301
301 301 301 301 301 301 301 301 301 301 301 301 301 301 301 301 301 301 301 301 301 301 301 301 301 301 301 301 301 301 301 301 301 301 301 301 301 301 301 301
301 301 301 301 301 301 301 301 301 301 301 301 301 301 301 301 301 301 301 301 301 301 301 301 301 301 301 301 301 301 301 301 301 301 301 301 301 301 301 301
