100 100
23 23 23 23 23 23 23 23 23 23 23 23 23 23 23 23 23 23 23 23 23 23 23 23 23 23 23 23 23 23 23 23 23 23 23 23 23 23 23 23 23 23 23 23 23 23 23 23 23 23 23 23 23 23 23 23 23 23 23 23 23 23 23 23 23 23 23 23 23 23 23 23 23 23 23 23 23 23 23 23 23 23 23 23 23 23 23 23 23 23 23 23 23 23 23 23 23 23 23 23
23 23 23 23 23 23 23 23 23 23 23 23 23 23 23 23 23 23 23 23 23 23 23 23 23 23 23 23 23 23 23 23 23 23 23 23 23 23 23 23 23 23 23 23 23 23 23 23 23 23 23 23 23 23 23 23 23 23 23 23 23 23 23 23 23 23 23 23 23 23 23 23 23 23 23 23 23 23 23 23 23 23 23 23 23 23 23 23 23 23 23 23 23 23 23 23 23 23 23 23
23 23 23 24 24 24 24 24 24 24 23 23 23 23 23 23 23 23 23 23 23 23 23 23 23 23 23 23 23 23 0 1 1 1 1 1 1 1 1 2 23 23 23 23 23 23 23 23 23 23 23 23 23 23 23 23 23 23 23 23 23 23 23 23 23 23 23 23 23 23 23 23 23 23 23 23 23 23 23 23 23 23 23 23 23 23 23 23 23 23 23 23 23 23 23 23 23 23 23 23
23 23 23 24 24 24 24 24 24 24 23 23 23 0 1 1 1 1 1 1 1 2 23 23 23 23 23 23 23 0 3 11 11 11 11 11 11 11 11 4 1 2 23 23 23 23 23 23 23 23 23 23 23 23 23 23 23 23 23 23 23 23 23 23 23 23 23 23 23 23 23 23 23 23 23 23 23 23 23 23 23 23 23 23 23 23 23 23 23 23 23 23 23 23 23 23 23 23 23 23
23 23 23 23 23 23 24 24 24 23 23 23 0 3 11 11 11 11 11 11 11 4 1 1 1 1 1 1 1 3 11 11 11 11 11 11 11 11 11 11 11 4 1 1 2 23 23 23 23 23 23 23 23 23 23 23 23 23 23 23 23 23 23 23 23 23 23 23 23 23 23 23 23 23 23 23 23 23 23 23 23 23 23 23 23 23 23 23 23 23 23 23 23 23 23 23 23 23 23 23
23 24 24 23 24 24 24 24 23 23 23 23 10 11 11 11 11 11 11 11 11 11 11 11 11 11 11 11 11 11 11 11 11 11 11 11 11 11 11 11 11 11 11 11 4 1 1 2 23 23 23 23 23 23 23 23 23 23 23 23 23 23 23 23 23 23 23 23 23 23 23 23 23 23 23 23 23 23 23 23 23 23 23 23 23 23 23 23 23 23 23 23 23 23 23 23 23 23 23 23
23 24 24 23 24 24 24 23 23 23 23 0 3 11 11 11 11 11 11 11 11 11 11 11 11 11 11 11 11 11 11 11 11 11 11 11 11 11 11 11 11 11 11 11 11 11 11 4 1 2 23 23 23 23 23 23 23 23 23 23 23 23 23 23 23 23 23 23 23 23 23 23 23 23 23 23 23 23 23 23 23 23 23 23 23 23 23 23 23 23 23 23 23 23 23 23 23 23 23 23
23 23 24 24 24 24 24 24 23 23 0 3 11 11 11 11 11 11 11 11 11 11 11 11 11 11 11 11 11 11 11 11 11 11 11 11 11 11 11 11 11 11 11 11 11 11 11 11 11 4 1 2 23 23 23 23 23 23 23 23 23 23 23 23 23 23 23 23 23 23 23 23 23 23 23 23 23 23 23 23 23 23 23 23 23 23 23 23 23 23 23 23 23 23 23 23 23 23 23 23
23 23 23 24 24 24 24 24 23 23 10 11 11 11 11 11 11 11 11 11 11 11 11 11 11 11 11 11 11 11 11 11 11 11 11 11 11 11 11 11 11 11 11 11 11 11 11 11 11 11 11 4 2 23 23 23 23 23 23 23 23 23 23 23 23 23 23 23 23 23 23 23 23 23 23 23 23 23 23 23 23 23 23 23 23 23 23 23 23 23 23 23 23 23 23 23 23 23 23 23
23 23 23 24 23 24 24 24 23 0 3 11 11 11 11 11 11 11 11 11 11 11 11 11 11 11 11 11 11 11 11 11 11 11 11 11 11 11 11 11 11 11 11 11 11 11 11 11 11 11 11 11 4 1 1 2 23 23 23 23 23 23 23 23 23 23 23 23 23 23 23 23 23 23 23 23 23 23 23 23 23 23 23 23 23 23 23 23 23 23 23 23 23 23 23 23 23 23 23 23
23 23 23 23 23 23 23 23 23 10 11 11 11 11 11 11 11 11 11 11 11 11 11 11 11 11 11 11 11 11 11 11 11 11 11 11 11 11 11 11 11 11 11 11 11 11 11 11 11 11 11 11 11 11 11 4 2 23 23 23 23 23 23 23 23 23 23 23 23 23 23 23 23 23 23 23 23 23 23 23 23 23 23 23 23 23 23 23 23 23 23 23 23 23 23 23 23 23 23 23
23 23 23 23 23 23 23 23 0 3 11 11 11 11 11 11 11 11 11 11 11 11 11 11 11 11 11 11 11 11 11 11 11 11 11 11 11 11 11 11 11 11 11 11 11 11 11 11 11 11 11 11 11 11 11 11 4 1 2 23 23 23 23 23 23 23 23 23 23 23 23 23 23 23 23 23 23 23 24 24 23 23 23 23 23 23 23 23 23 23 23 23 23 23 23 23 23 23 23 23
23 23 23 23 23 23 23 23 10 11 11 11 11 11 11 11 11 11 11 11 11 11 11 11 11 11 11 11 11 11 11 11 11 11 11 11 11 11 11 11 11 11 11 11 11 11 11 11 11 11 11 11 11 11 11 11 11 11 4 2 23 23 23 23 23 23 23 23 23 23 23 23 23 23 23 23 24 24 24 24 23 23 23 23 23 0 1 1 1 1 1 1 2 23 23 23 23 23 23 23
23 23 23 23 23 23 23 23 10 11 11 11 11 11 11 11 11 11 11 11 11 11 11 11 11 11 11 11 11 11 11 11 11 11 11 11 11 11 11 11 11 11 11 11 11 11 11 11 11 11 11 11 11 11 11 11 11 11 11 4 2 23 23 23 23 23 23 23 23 23 23 23 23 23 23 24 24 23 24 24 23 23 23 0 1 3 11 11 11 11 11 11 4 2 23 23 23 23 23 23
23 23 23 24 24 23 23 23 10 11 11 11 11 11 11 11 11 11 11 11 11 11 11 11 11 11 11 11 11 11 11 11 11 11 11 11 11 11 11 11 11 11 11 11 11 11 11 11 11 11 11 11 11 11 11 11 11 11 11 11 4 2 23 23 23 23 23 23 24 23 23 23 23 23 23 24 23 23 24 23 23 23 0 3 11 11 11 11 11 11 11 11 11 4 2 23 23 23 23 23
23 24 24 24 23 23 23 23 10 11 11 11 11 11 11 11 11 11 11 11 11 11 11 11 11 11 11 11 11 11 11 11 11 11 16 16 16 16 16 16 16 16 16 16 16 16 11 11 11 11 11 11 11 11 11 11 11 11 11 11 11 12 23 23 23 23 23 23 24 24 23 24 24 23 23 24 23 23 24 23 23 23 10 11 11 11 11 11 11 11 11 11 11 11 12 23 23 23 23 23
24 24 23 24 23 23 23 0 3 11 11 11 11 11 11 11 11 11 11 11 11 11 11 11 11 11 11 11 11 11 11 16 16 16 16 16 16 16 16 16 16 16 16 16 16 16 16 16 11 11 11 11 11 11 11 11 11 11 11 11 11 4 2 23 23 23 23 23 23 24 24 24 24 24 23 23 23 23 24 23 23 23 10 11 11 11 11 11 11 11 11 11 11 11 12 23 23 23 23 23
24 24 23 24 23 23 23 10 11 11 11 11 11 11 11 11 11 11 11 11 11 11 11 11 11 11 11 11 16 16 16 16 16 16 16 16 16 16 16 16 16 16 16 16 16 16 16 16 16 11 11 11 11 11 11 11 11 11 11 11 11 11 4 2 23 23 23 23 23 24 24 23 23 24 23 23 23 23 24 23 23 0 3 11 11 11 11 11 11 11 11 11 11 11 4 2 23 23 23 23
23 24 24 24 24 24 23 10 11 11 11 11 11 11 11 11 11 11 11 11 11 11 11 11 11 11 16 16 16 16 16 16 16 16 16 16 16 16 16 16 16 16 16 16 16 16 16 16 16 16 11 11 11 11 11 11 11 11 11 11 11 11 11 12 23 23 23 23 23 24 24 23 23 24 23 23 23 24 24 23 23 10 11 11 11 11 11 11 11 11 11 11 11 11 11 12 23 23 23 23
23 24 24 24 23 23 23 10 11 11 11 11 11 11 11 11 11 11 11 11 11 11 11 11 11 16 16 16 16 16 16 16 16 16 16 16 16 16 16 16 16 16 16 16 16 16 16 16 16 16 16 11 11 11 11 11 11 11 11 11 11 11 11 4 2 23 23 23 23 24 24 23 23 24 23 23 23 24 23 23 23 10 11 11 11 11 11 11 11 11 11 11 11 11 11 12 23 23 23 23
23 23 24 23 23 23 23 10 11 11 11 11 11 11 11 11 11 11 11 11 11 11 11 11 11 16 16 16 16 16 16 16 16 16 16 16 16 16 16 16 16 16 16 16 16 16 16 16 16 16 16 11 11 11 11 11 11 11 11 11 11 11 11 11 4 2 23 23 23 24 24 24 23 24 23 23 23 24 23 23 0 3 11 11 11 11 11 11 11 11 11 11 11 11 11 12 23 23 23 23
23 23 24 24 23 23 23 10 11 11 11 11 11 11 11 11 11 11 11 11 11 11 11 11 11 16 16 16 16 11 11 11 11 11 11 11 11 11 11 11 11 11 11 11 11 11 11 11 16 16 16 11 11 11 11 11 11 11 11 11 11 11 11 11 11 12 23 23 24 24 23 24 24 24 23 23 24 24 23 23 10 11 11 11 11 11 11 11 11 11 11 11 11 11 11 12 23 23 23 23
23 24 24 24 23 23 23 10 11 11 11 11 11 11 11 11 11 11 11 11 11 11 11 11 16 16 16 16 16 11 11 11 11 11 11 11 11 11 11 11 11 11 11 11 11 11 11 11 16 16 16 11 11 11 11 11 11 11 11 11 11 11 11 11 11 12 23 23 24 24 23 23 24 24 24 24 24 23 23 23 10 11 11 11 11 11 11 11 11 11 11 11 11 11 11 12 23 23 23 23
23 24 24 24 23 23 23 10 11 11 11 11 11 11 11 11 11 11 11 11 11 11 11 11 16 16 16 11 11 11 11 11 11 11 11 11 11 11 11 11 11 11 11 11 11 11 11 11 16 16 16 11 11 11 11 11 11 11 11 11 11 11 11 11 11 4 2 23 24 24 23 23 23 24 23 23 23 23 23 0 3 11 11 11 11 11 11 11 11 11 11 11 11 11 11 12 23 23 23 23
23 23 23 24 24 23 23 10 11 11 11 11 11 11 11 11 11 11 11 11 11 11 11 16 16 16 11 11 11 11 11 11 16 16 16 16 16 16 11 11 11 11 11 11 11 11 11 11 16 16 16 11 11 11 11 11 11 11 11 11 11 11 11 11 11 11 12 23 23 23 23 23 23 24 23 23 23 23 23 10 11 11 11 11 11 11 11 11 11 11 11 11 11 11 11 12 23 23 23 23
23 23 23 24 24 23 23 10 11 11 11 11 11 11 11 11 11 11 11 11 11 11 11 16 16 16 11 11 11 11 11 16 16 16 16 16 16 16 16 16 11 11 11 11 11 11 11 11 16 16 16 11 11 11 11 11 11 11 11 11 11 11 11 11 11 11 12 23 23 23 23 23 23 24 23 23 23 23 23 10 11 11 11 11 11 11 11 11 11 11 11 11 11 11 11 12 23 23 23 23
23 23 23 23 24 23 23 10 11 11 11 11 11 11 11 11 11 11 11 11 11 11 16 16 16 16 11 11 11 11 16 16 16 16 16 16 16 16 16 16 16 11 11 11 11 11 11 16 16 16 11 11 11 11 11 11 11 11 11 11 11 11 11 11 11 11 12 23 23 23 23 23 23 24 23 23 23 23 0 3 11 11 11 11 11 11 11 11 11 11 11 11 11 11 11 12 23 23 23 23
23 23 23 23 23 23 23 10 11 11 11 11 11 11 11 11 11 11 11 11 11 11 16 16 16 16 11 11 11 11 16 16 16 16 16 16 16 16 16 16 16 11 11 11 11 11 11 16 16 16 11 11 11 11 11 11 11 11 11 11 11 11 11 11 11 11 12 23 23 23 23 23 23 24 24 23 23 23 10 11 11 11 11 11 11 11 11 11 11 11 11 11 11 11 11 12 23 23 23 23
23 23 23 23 23 23 23 10 11 11 11 11 11 11 11 11 11 11 11 11 11 11 16 16 16 11 11 11 11 11 16 16 16 16 16 16 16 16 16 16 16 11 11 11 11 11 16 16 16 16 11 11 11 11 11 11 11 11 11 11 11 11 11 11 11 11 4 2 23 23 23 23 23 23 24 23 23 23 10 11 11 11 11 11 11 11 11 11 11 11 11 11 11 11 11 12 23 23 23 23
23 23 23 23 23 23 23 10 11 11 11 11 11 11 11 11 11 11 11 11 11 11 16 16 16 11 11 11 11 11 16 16 16 16 16 16 16 16 16 16 16 11 11 11 11 11 16 16 16 11 11 11 11 11 11 11 11 11 11 11 11 11 11 11 11 11 11 12 23 23 23 23 23 23 23 23 23 23 10 11 11 11 11 11 11 11 11 11 11 11 11 11 11 11 11 12 23 23 23 23
23 23 23 23 23 23 23 10 11 11 11 11 11 11 11 11 11 11 11 11 11 11 16 16 16 11 11 11 16 16 16 16 16 16 16 16 16 16 16 16 16 11 11 11 11 16 16 16 16 11 11 11 11 11 11 11 11 11 11 11 11 11 11 11 11 11 11 12 23 23 23 23 23 23 23 23 23 23 10 11 11 11 11 11 11 11 11 11 11 11 11 11 11 11 11 12 23 23 23 23
23 23 23 24 23 23 23 10 11 11 11 11 11 11 11 11 11 11 11 11 11 11 16 16 16 16 16 16 16 16 16 16 16 16 16 16 16 16 16 16 11 11 11 11 16 16 16 16 16 11 11 11 11 11 11 11 11 11 11 11 11 11 11 11 11 11 11 12 23 23 23 23 23 23 23 23 23 23 10 11 11 11 11 11 11 11 11 11 11 11 11 11 11 11 11 12 23 23 23 23
23 23 23 24 23 23 23 10 11 11 11 11 11 11 11 11 11 11 11 11 11 11 11 16 16 16 16 16 16 16 16 16 16 16 16 16 16 16 11 11 11 11 11 16 16 16 16 16 16 11 11 11 11 11 11 11 11 11 11 11 11 11 11 11 11 11 11 12 23 23 23 23 23 23 23 23 23 23 10 11 11 11 11 11 11 11 11 11 11 11 11 11 11 11 14 22 23 23 23 23
23 23 23 24 23 23 23 10 11 11 11 11 11 11 11 11 11 11 11 11 11 11 11 16 16 16 16 16 16 16 16 16 16 16 16 16 11 11 11 11 11 11 11 16 16 16 16 16 16 11 11 11 11 11 11 11 11 11 11 11 11 11 11 11 11 11 11 12 23 23 23 23 23 23 23 23 23 23 10 11 11 11 11 11 11 11 11 11 11 11 11 11 11 11 12 23 23 23 23 23
23 23 24 24 23 23 23 20 13 11 11 11 11 11 11 11 11 11 11 11 11 11 11 11 11 11 11 11 11 11 11 11 11 11 11 11 11 11 11 11 11 11 16 16 16 16 16 16 11 11 11 11 11 11 11 11 11 11 11 11 11 11 11 11 11 11 11 4 1 2 23 23 23 23 23 23 23 0 3 11 11 11 11 11 11 11 11 11 11 11 11 11 11 11 12 23 23 23 23 23
23 24 24 24 23 23 23 23 10 11 11 11 11 11 11 11 11 11 11 11 11 11 11 11 11 11 11 11 11 11 11 11 11 11 11 11 11 11 11 11 11 11 16 16 16 16 16 16 11 11 11 11 11 11 11 11 11 11 11 11 11 11 11 11 11 11 11 11 11 4 1 1 1 2 23 23 0 3 11 11 11 11 11 11 11 11 11 11 11 11 11 11 11 11 12 23 23 23 23 23
23 24 24 24 24 23 23 23 10 11 11 11 11 11 11 11 11 11 11 11 11 11 11 11 11 11 11 11 11 11 11 11 11 11 11 11 11 11 11 11 11 16 16 16 16 16 16 11 11 11 11 11 11 11 11 11 11 11 11 11 11 11 11 11 11 11 11 11 11 11 11 11 11 4 1 1 3 11 11 11 11 11 11 11 11 11 11 11 11 11 11 11 11 11 4 2 23 23 23 23
24 24 24 24 24 23 23 23 20 13 11 11 11 11 11 11 11 11 11 11 11 11 11 11 11 11 11 11 11 11 11 11 11 11 11 11 11 11 11 11 16 16 16 16 16 16 16 11 11 11 11 11 11 11 11 11 11 11 11 11 11 11 11 11 11 11 11 11 11 11 11 11 11 11 11 11 11 11 11 11 11 11 11 11 11 11 11 11 11 11 11 11 11 11 11 12 23 23 23 23
24 24 24 24 24 24 23 23 23 10 11 11 11 11 11 11 11 11 11 11 11 11 11 11 11 11 11 11 11 11 11 11 11 11 11 11 11 11 16 16 16 16 16 16 16 16 11 11 11 11 11 11 11 11 11 11 11 11 11 11 11 11 11 11 11 11 11 11 11 11 11 11 11 11 11 11 11 11 11 11 11 11 11 11 11 11 11 11 11 11 11 11 11 11 11 12 23 23 23 23
23 24 24 24 24 23 23 23 23 20 13 11 11 11 11 11 11 11 11 11 11 11 11 11 11 11 11 11 11 11 11 11 11 11 11 11 11 16 16 16 16 16 16 16 16 16 11 11 11 11 11 11 11 11 11 11 11 11 11 11 11 11 11 11 11 11 11 11 11 11 11 11 11 11 11 11 11 11 11 11 11 11 11 11 11 11 11 11 11 11 11 11 11 11 11 12 23 23 23 23
23 23 23 24 23 23 23 23 23 23 10 11 11 11 11 11 11 11 11 11 11 11 11 11 11 11 11 11 11 16 11 11 11 11 11 11 16 16 16 16 16 16 16 16 16 11 11 11 11 11 11 11 11 11 11 11 11 11 11 11 11 11 11 11 11 11 11 11 11 11 11 11 11 11 11 11 11 11 11 11 11 11 11 11 11 11 11 11 11 11 11 11 11 11 11 12 23 23 23 23
23 23 23 23 23 23 23 23 23 23 10 11 11 11 11 11 11 11 11 11 11 11 11 11 11 16 16 16 16 16 11 11 11 11 11 16 16 16 16 16 16 16 16 16 11 11 11 11 11 11 11 11 11 11 11 11 11 11 11 11 11 11 11 11 11 11 11 11 11 11 11 11 11 11 11 11 11 11 11 11 11 11 11 11 11 11 11 11 11 11 11 11 11 11 11 12 23 23 23 23
23 23 23 23 23 23 23 23 23 23 20 13 11 11 11 11 11 11 11 11 11 11 11 11 16 16 16 16 16 16 16 16 16 16 16 16 16 16 16 16 16 16 16 11 11 11 11 11 11 11 11 11 11 11 11 11 11 11 11 11 11 11 11 11 11 11 11 11 11 11 11 11 11 11 11 11 11 11 11 11 11 11 11 11 11 11 11 11 11 11 11 11 11 11 11 12 23 23 23 23
23 23 23 23 23 23 23 23 23 23 23 10 11 11 11 11 11 11 11 11 11 11 11 16 16 16 16 16 16 16 16 16 16 16 16 16 16 16 16 16 16 16 11 11 11 11 11 11 11 11 11 11 11 11 11 11 11 11 11 11 11 11 11 11 11 11 11 11 11 11 11 11 11 11 11 11 11 11 11 11 11 11 11 11 11 11 11 11 11 11 11 11 11 11 11 12 23 23 23 23
23 23 23 23 23 23 23 23 23 23 23 10 11 11 11 11 11 11 11 11 11 11 16 16 16 16 16 16 16 16 16 16 16 16 16 16 16 16 16 11 11 11 11 11 11 11 11 11 11 11 11 11 11 11 11 11 11 11 11 11 11 14 13 11 11 11 11 11 11 11 11 11 11 11 11 11 11 11 11 11 11 11 11 11 11 11 11 11 11 11 11 11 11 11 11 4 2 23 23 23
23 23 23 23 23 23 23 23 23 23 23 20 13 11 11 11 11 11 11 11 11 11 16 16 16 16 16 16 16 16 16 16 16 16 16 16 11 11 11 11 11 11 11 11 11 11 11 11 11 11 11 11 11 11 11 11 11 11 11 14 21 22 10 11 11 11 11 11 11 11 11 11 11 11 11 11 11 11 11 11 11 11 11 11 11 11 11 11 11 11 11 11 11 11 11 11 12 23 23 23
23 23 23 23 23 23 23 23 23 23 23 23 10 11 11 11 11 11 11 11 11 11 11 11 16 16 16 16 16 16 16 16 16 16 11 11 11 11 11 11 11 11 11 11 11 11 11 11 11 11 11 11 11 11 11 11 14 21 21 22 23 23 20 13 11 11 11 11 11 11 11 11 11 11 11 11 11 11 11 11 11 11 11 11 11 11 11 11 11 11 11 11 11 11 11 11 12 23 23 23
23 23 23 23 23 23 23 23 23 23 23 23 20 13 11 11 11 11 11 11 11 11 11 11 11 11 16 16 16 16 16 16 11 11 11 11 11 11 11 11 11 11 11 11 11 11 11 11 11 11 11 11 11 11 14 21 22 23 23 23 23 23 23 20 21 13 11 11 11 11 11 11 11 11 11 11 11 11 11 11 11 11 11 11 11 11 11 11 11 11 11 11 11 11 11 11 12 23 23 23
23 23 23 23 23 23 23 23 23 23 23 23 23 10 11 11 11 11 11 11 11 11 11 11 11 11 11 11 11 11 11 11 11 11 11 11 11 11 11 11 11 11 11 11 11 11 11 11 11 11 11 14 21 21 22 23 23 23 23 23 23 23 23 23 0 3 11 11 11 11 11 11 11 11 11 11 11 11 11 11 11 11 11 11 11 11 11 11 11 11 11 11 11 11 11 11 12 23 23 23
23 23 23 23 24 24 24 24 24 23 23 23 23 20 21 13 11 11 11 11 11 11 11 11 11 11 11 11 11 11 11 11 11 11 11 11 11 11 11 11 11 11 11 11 11 11 11 11 11 14 21 22 23 23 23 23 23 23 23 23 23 23 0 1 3 11 11 11 11 11 11 11 11 11 11 11 11 11 11 11 11 11 11 11 11 11 11 11 11 11 11 11 11 11 11 11 12 23 23 23
23 23 23 24 24 24 24 23 24 23 23 23 23 23 23 20 13 11 11 11 11 11 11 11 11 11 11 11 11 11 11 11 11 11 11 11 11 11 11 11 11 11 11 11 11 11 14 21 21 22 23 23 23 23 23 23 24 24 23 23 23 0 3 11 11 11 11 11 11 11 11 11 11 11 11 11 11 11 11 11 11 11 11 11 11 11 11 11 11 11 11 11 11 11 11 11 12 23 23 23
23 23 24 23 23 24 23 23 24 23 23 23 23 23 23 23 20 21 21 13 11 11 11 11 11 11 11 11 11 11 11 11 11 11 11 11 11 11 11 11 11 11 14 21 21 21 22 23 23 23 23 23 23 23 24 24 24 23 23 23 0 3 11 11 11 11 11 11 11 11 11 11 11 11 11 11 11 11 11 11 11 11 11 11 11 11 11 11 11 11 11 11 11 11 11 11 12 23 23 23
23 24 23 23 24 24 24 23 24 23 23 23 23 23 23 23 23 23 23 20 21 21 21 21 21 21 21 21 21 21 21 21 13 11 11 11 11 11 11 11 11 11 12 23 23 23 23 23 23 23 23 24 24 24 24 23 23 23 23 0 3 11 11 11 11 11 11 11 11 11 11 11 11 11 11 11 11 11 11 11 11 11 11 11 11 11 11 11 11 11 11 11 11 11 11 14 22 23 23 23
23 24 23 23 24 23 24 24 24 23 23 23 23 23 23 23 23 23 23 23 23 23 23 23 23 23 23 23 23 23 23 23 20 13 11 11 11 11 11 11 11 11 12 23 23 23 23 23 23 23 24 24 24 24 24 23 23 23 23 10 11 11 11 11 11 11 11 11 11 11 11 11 11 11 11 11 11 11 11 11 11 11 11 11 11 11 11 11 11 11 11 11 11 11 11 12 23 23 23 23
23 24 23 23 24 24 24 24 24 23 23 23 23 23 23 23 23 23 23 23 23 23 23 23 23 23 23 23 23 23 23 23 23 10 11 11 11 11 11 11 11 11 12 23 23 23 23 23 23 24 24 24 24 24 24 23 23 23 23 10 11 11 11 11 11 11 11 11 11 11 11 11 11 11 11 11 11 11 11 11 11 11 11 11 11 11 11 11 11 11 11 11 11 11 11 4 2 23 23 23
23 24 23 23 23 24 24 24 24 23 23 23 23 23 23 23 23 23 23 23 23 23 23 23 23 23 23 23 23 23 23 23 0 3 11 11 11 11 11 11 11 11 12 23 23 23 23 23 23 24 24 24 23 24 24 23 23 23 0 3 11 11 11 11 11 11 11 11 11 11 11 11 11 11 11 11 11 11 11 11 11 11 11 11 11 11 11 11 11 11 11 11 11 11 11 11 12 23 23 23
23 24 24 24 24 24 24 23 24 23 23 23 23 23 23 23 23 23 23 23 23 23 23 23 23 23 23 23 23 23 23 23 10 11 11 11 11 11 11 11 11 11 4 2 23 23 23 23 24 24 24 24 23 24 24 23 23 23 10 11 11 11 11 11 11 11 11 11 11 11 11 11 11 11 11 11 11 11 11 11 11 11 11 11 11 11 11 11 11 11 11 11 11 11 11 11 12 23 23 23
23 23 23 23 23 24 23 23 24 23 23 23 23 23 23 23 23 24 24 23 23 23 23 23 23 23 23 23 23 23 23 0 3 11 11 11 11 11 11 11 11 11 11 12 23 23 23 23 24 23 24 24 23 24 23 23 23 23 10 11 11 11 11 11 11 11 11 11 11 11 11 11 11 11 11 11 11 11 11 11 11 11 11 11 11 11 11 11 11 11 11 11 11 11 11 11 4 2 23 23
23 23 23 23 24 24 23 23 24 23 23 23 23 23 23 23 23 24 23 23 23 23 23 23 23 23 23 23 23 23 0 3 11 11 11 11 11 11 11 11 11 11 11 12 23 23 23 23 24 23 24 24 23 24 23 23 23 23 10 11 11 11 11 11 11 11 11 11 11 11 11 11 11 11 11 11 11 11 11 11 11 11 11 11 11 11 11 11 11 11 11 11 11 11 11 11 11 12 23 23
23 23 23 24 24 23 23 23 24 23 23 23 23 23 23 23 24 24 23 23 23 23 23 23 23 23 23 23 23 23 10 11 11 11 11 11 11 11 11 11 11 11 11 4 2 23 23 23 24 23 24 24 23 24 23 23 23 23 10 11 11 11 11 11 11 11 11 11 11 11 11 11 11 11 11 11 11 11 11 11 11 11 11 11 11 11 11 11 11 11 11 11 11 11 11 11 11 12 23 23
23 23 23 24 23 23 23 24 24 23 23 23 23 23 23 23 24 23 23 23 23 24 24 23 23 23 23 23 23 0 3 11 11 11 11 11 11 11 11 11 11 11 11 11 12 23 23 23 24 23 24 24 24 24 24 23 23 23 20 13 11 11 11 11 11 11 11 11 11 11 11 11 11 11 11 11 11 11 11 11 11 11 11 11 11 11 11 11 11 11 11 11 11 11 11 11 11 12 23 23
23 23 23 24 24 23 24 24 23 23 23 23 23 23 23 23 24 24 23 23 24 24 24 23 23 23 23 23 23 10 11 11 11 11 11 11 11 11 11 11 11 11 11 11 4 2 23 23 24 24 24 24 24 24 24 24 23 23 23 20 13 11 11 11 11 11 11 11 11 11 11 11 11 11 11 11 11 11 11 11 11 11 11 11 11 11 11 11 11 11 11 11 11 11 11 11 11 12 23 23
23 23 23 23 24 24 24 23 23 23 23 23 23 23 23 23 23 24 24 24 24 24 23 23 23 23 23 23 23 10 11 11 11 11 11 11 11 11 11 11 11 11 11 11 11 12 23 23 23 24 24 24 24 24 24 24 23 23 23 23 20 13 11 11 11 11 11 11 11 11 11 11 11 11 11 11 11 11 11 11 11 11 11 11 11 11 11 11 11 11 11 11 11 11 11 11 11 12 23 23
23 23 23 23 23 23 23 23 23 23 23 23 23 23 23 23 23 23 23 24 23 23 23 23 23 23 23 23 0 3 11 11 11 11 11 11 11 11 11 11 11 11 11 11 11 4 2 23 23 24 23 24 24 24 24 24 24 23 23 23 23 20 21 13 11 11 11 11 11 11 11 11 11 11 11 11 11 11 11 11 11 11 11 11 11 11 11 11 11 11 11 11 11 11 11 11 11 12 23 23
23 23 23 23 23 23 23 23 23 23 23 23 23 23 23 23 23 23 23 24 23 23 23 23 23 23 23 0 3 11 11 11 11 11 11 11 11 11 11 11 11 11 11 11 11 11 4 2 23 23 24 24 24 24 24 24 24 23 23 23 23 23 23 20 13 11 11 11 11 11 11 11 11 11 11 11 11 11 11 11 11 11 11 11 11 11 11 11 11 11 11 11 11 11 11 11 11 12 23 23
23 23 23 23 23 23 23 23 23 23 23 23 23 23 23 23 23 23 23 24 23 23 23 23 23 23 23 10 11 11 11 11 11 11 11 11 11 11 11 11 11 11 11 11 11 11 11 12 23 23 23 24 24 24 24 24 24 23 23 23 23 23 23 23 20 21 21 21 21 21 13 11 11 11 11 11 11 11 11 11 11 11 11 11 11 11 11 11 11 11 11 11 11 11 11 11 11 12 23 23
23 23 23 23 23 23 23 23 23 23 23 23 23 23 23 24 23 23 23 24 23 23 23 23 23 23 0 3 11 11 11 11 11 11 11 11 11 11 11 11 11 11 11 11 11 11 11 4 2 23 23 23 24 24 24 24 24 24 23 23 23 23 23 23 23 23 23 23 23 23 20 21 21 21 21 21 13 11 11 11 11 11 11 11 11 11 11 11 11 11 11 11 11 11 11 11 11 12 23 23
23 23 23 23 23 23 23 23 23 23 23 23 23 23 24 24 24 24 24 24 23 23 23 23 23 0 3 11 11 11 11 11 11 11 11 11 11 11 11 11 11 11 11 11 11 11 11 11 12 23 23 23 23 24 24 23 23 24 24 24 23 23 23 23 23 23 23 23 23 23 23 23 23 23 23 23 20 21 21 21 21 13 11 11 11 11 11 11 11 11 11 11 11 11 11 11 14 22 23 23
23 23 23 23 23 23 23 23 23 23 23 23 23 23 24 23 24 24 24 24 23 23 23 23 0 3 11 11 11 11 11 11 11 11 11 11 11 11 11 11 11 11 11 11 11 11 11 11 4 2 23 23 23 23 23 23 23 23 23 23 23 23 23 23 23 23 23 23 23 23 23 23 23 23 23 23 23 23 23 23 23 20 21 21 13 11 11 11 11 11 11 11 11 11 11 11 12 23 23 23
23 23 23 23 23 23 23 23 23 23 23 23 23 23 24 24 23 23 23 23 23 23 23 23 10 11 11 11 11 11 11 11 11 11 11 11 11 11 11 11 11 11 11 11 11 11 11 11 11 12 23 23 23 23 23 23 23 23 23 23 23 23 23 23 23 23 23 23 23 23 23 23 23 23 23 23 23 23 23 23 23 23 23 23 20 21 21 13 11 11 11 11 11 11 11 11 12 23 23 23
23 23 23 23 23 23 23 23 23 23 23 23 24 24 24 24 24 23 23 23 23 23 23 0 3 11 11 11 11 11 11 11 11 11 11 11 11 11 11 11 11 11 11 11 11 11 11 11 11 4 1 1 2 23 23 23 23 23 23 23 23 23 23 23 23 23 23 23 24 23 23 23 23 23 23 23 23 23 23 23 23 23 23 23 23 23 23 20 21 13 11 11 11 11 11 14 22 23 23 23
23 23 23 23 23 23 23 23 23 23 24 24 24 23 23 23 23 23 23 23 23 23 23 10 11 11 11 11 11 11 11 11 11 11 11 11 11 11 11 11 11 11 11 11 11 11 11 11 11 11 11 11 4 1 1 1 2 23 23 23 23 23 23 23 23 23 23 23 24 24 24 24 23 23 23 23 23 23 23 23 23 23 23 23 23 23 23 23 23 20 21 21 21 21 21 22 23 23 23 23
23 23 23 23 23 23 23 23 23 23 24 24 23 23 23 23 23 23 23 23 23 23 23 10 11 11 11 11 11 11 11 11 11 11 11 11 11 11 11 11 11 11 11 11 11 11 11 11 11 11 11 11 11 11 11 11 4 1 1 2 23 23 23 23 23 23 23 23 23 23 24 24 24 24 24 23 23 23 24 24 23 23 23 23 23 23 23 23 23 23 23 23 23 23 23 23 23 23 23 23
23 23 23 23 23 23 23 23 23 23 23 23 23 23 23 23 23 23 23 23 23 23 23 10 11 11 11 11 11 11 11 11 11 11 11 11 11 11 11 11 11 11 11 11 11 11 11 11 11 11 11 11 11 11 11 11 11 11 11 4 1 1 1 2 23 23 23 23 23 23 23 23 23 23 24 24 23 23 24 23 24 24 23 23 23 23 23 23 23 23 23 23 23 23 23 23 23 23 23 23
23 23 23 23 24 24 24 23 23 23 23 23 23 23 23 23 23 23 23 23 23 23 0 3 11 11 11 11 11 11 11 11 11 11 11 11 11 11 11 11 11 11 11 11 11 11 11 11 11 11 11 11 11 11 11 11 11 11 11 11 11 11 11 4 1 1 1 1 2 23 23 23 23 23 23 24 24 24 24 23 23 24 24 23 23 23 23 23 23 23 23 23 23 23 23 23 23 23 23 23
23 23 23 23 24 23 24 24 23 23 23 23 23 23 23 23 23 23 23 23 23 23 10 11 11 11 11 11 11 11 11 11 11 11 11 11 11 11 11 11 11 11 11 11 11 11 11 11 11 11 11 11 11 11 11 11 11 11 11 11 11 11 11 11 11 11 11 11 4 1 1 2 23 23 23 23 23 24 24 23 23 23 23 24 24 23 23 23 23 23 23 23 23 24 23 23 23 23 23 23
23 23 23 24 24 23 23 24 23 23 23 23 23 23 23 23 23 23 23 23 23 0 3 11 11 11 11 11 11 11 11 11 11 11 11 11 11 11 11 11 11 11 11 11 11 11 11 11 11 11 11 11 11 11 11 11 11 11 11 11 11 11 11 11 11 11 11 11 11 11 11 4 1 1 2 23 23 24 24 23 23 23 23 23 24 24 24 24 23 23 23 23 23 24 23 23 23 23 23 23
23 23 23 24 23 23 24 24 23 23 23 23 23 23 23 23 23 23 23 23 23 10 11 11 11 11 11 11 11 11 11 11 11 11 11 11 11 11 11 11 11 11 11 11 11 11 11 11 11 11 11 11 11 11 11 11 11 11 11 11 11 11 11 11 11 11 11 11 11 11 11 11 11 11 4 1 2 23 24 23 23 23 23 23 23 23 23 23 23 23 23 23 23 24 23 23 23 23 23 23
23 23 23 23 24 24 24 23 23 23 23 23 23 23 23 23 23 23 23 23 0 3 11 11 11 11 11 11 11 11 11 11 11 11 11 11 11 11 11 11 11 11 11 11 11 11 11 11 11 11 11 11 11 11 11 11 11 11 11 11 11 11 11 11 11 11 11 11 11 11 11 11 11 11 11 11 4 1 1 2 23 23 23 23 23 23 23 23 23 23 23 23 23 24 24 23 23 23 23 23
23 23 23 23 23 23 23 23 23 23 23 23 23 23 23 23 23 23 23 0 3 11 11 11 11 11 11 11 11 11 11 11 11 11 11 11 11 11 11 11 11 11 11 11 11 11 11 11 11 11 11 11 11 11 11 11 11 11 11 11 11 11 11 11 11 11 11 11 11 11 11 11 11 11 11 11 11 11 11 4 1 1 2 23 23 23 23 23 23 23 23 23 23 24 24 24 23 23 23 23
23 23 23 23 23 23 23 23 23 23 23 23 23 23 23 0 1 1 1 3 11 11 11 11 11 11 11 11 11 11 11 11 11 11 11 11 11 11 11 11 11 11 11 11 11 11 11 11 11 11 11 11 11 11 11 11 11 11 11 11 11 11 11 11 11 11 11 11 11 11 11 11 11 11 11 11 11 11 11 11 11 11 4 1 2 23 23 23 23 23 23 23 23 24 23 23 23 23 23 23
23 23 23 23 23 23 23 23 23 23 23 23 0 1 1 3 11 11 11 11 11 11 11 11 11 11 11 11 11 11 11 11 11 11 11 11 11 11 11 11 11 11 11 11 11 11 11 11 11 11 11 11 11 11 11 11 11 11 11 11 11 11 11 11 11 11 11 11 11 11 11 11 11 11 11 11 11 11 11 11 11 11 11 11 12 23 23 23 23 23 23 23 23 24 23 23 23 23 23 23
23 23 23 23 23 23 23 23 23 0 1 1 3 11 11 11 11 11 11 11 11 11 11 11 11 11 11 11 11 11 11 11 11 11 11 11 11 11 11 11 11 11 11 11 11 11 11 11 11 11 11 11 11 11 11 11 11 11 11 11 11 11 11 11 11 11 11 11 11 11 11 11 11 11 11 11 11 11 11 11 11 11 11 11 4 1 2 23 23 23 23 23 23 24 24 23 23 23 23 23
23 23 23 23 23 23 23 23 0 3 11 11 11 11 11 11 11 11 11 11 11 11 11 11 11 11 11 11 11 11 11 11 11 11 11 11 11 11 11 11 11 11 11 11 11 11 11 11 11 11 11 11 11 11 11 11 11 11 11 11 11 11 11 11 11 11 11 11 11 11 11 11 11 11 11 11 11 11 11 11 11 11 11 11 11 11 12 23 23 23 23 23 23 23 24 23 23 23 23 23
23 23 23 23 23 23 23 23 10 11 11 11 11 11 11 11 11 11 11 11 11 11 11 11 11 11 11 11 11 11 11 11 11 11 11 11 11 11 11 11 11 11 11 11 11 11 11 11 11 11 11 11 11 11 11 11 11 11 11 11 11 11 11 11 11 11 11 11 11 11 11 11 11 11 11 11 11 11 11 11 11 11 11 11 11 11 4 2 23 23 23 23 23 23 24 24 23 23 23 23
23 23 23 23 23 23 23 23 10 11 11 11 11 11 11 11 11 11 11 11 11 11 11 11 11 11 11 11 11 11 11 11 11 11 11 11 11 11 11 11 11 11 11 11 11 11 11 11 11 11 11 11 11 11 11 11 11 11 11 11 11 11 11 11 11 11 11 11 11 11 11 11 11 11 11 11 11 11 11 11 11 11 11 11 11 11 11 12 23 23 23 23 23 24 23 24 23 23 23 23
23 23 23 23 23 23 23 23 10 11 11 11 11 11 11 11 11 11 11 11 11 11 11 11 11 11 11 11 11 11 11 11 11 11 11 11 11 11 11 11 11 11 11 11 11 11 11 11 11 11 11 11 11 11 11 11 11 11 11 11 11 11 11 11 11 11 11 11 11 11 11 11 11 11 11 11 11 11 11 11 11 11 11 11 11 11 11 4 2 23 23 23 23 24 23 24 24 23 23 23
23 23 23 23 23 23 23 23 10 11 11 11 11 11 11 11 11 11 11 11 11 11 11 11 11 11 11 11 11 11 11 11 11 11 11 11 11 11 11 11 11 11 11 11 11 11 11 11 11 11 11 11 11 11 11 11 11 11 11 11 11 11 11 11 11 11 11 11 11 11 11 11 11 11 11 11 11 11 11 11 11 11 11 11 11 11 11 11 4 2 23 23 23 24 24 23 24 23 23 23
23 23 23 23 23 23 23 23 10 11 11 11 11 11 11 11 11 11 11 11 11 11 11 11 11 11 11 11 11 11 11 11 11 11 11 11 11 11 11 11 11 11 11 11 11 11 11 11 11 11 11 11 11 11 11 11 11 11 11 11 11 11 11 11 11 11 11 11 11 11 11 11 11 11 11 11 11 11 11 11 11 11 11 11 11 11 11 11 11 12 23 23 23 23 24 23 24 23 23 23
23 23 23 23 23 23 23 23 10 11 11 11 11 11 11 11 11 11 11 11 11 11 11 11 11 11 11 11 11 11 11 11 11 11 11 11 11 11 11 11 11 11 11 11 11 11 11 11 11 11 11 11 11 11 11 11 11 11 11 11 11 11 11 11 11 11 11 11 11 11 11 11 11 11 11 11 11 11 11 11 11 11 11 11 11 11 11 11 11 12 23 23 23 23 24 23 24 23 23 23
23 23 23 23 23 23 23 23 20 13 11 11 11 11 11 11 11 11 11 11 11 11 11 11 11 11 11 11 11 11 11 11 11 11 11 11 11 11 11 11 11 11 11 11 11 11 11 11 11 11 11 11 11 11 11 11 11 11 11 11 11 11 11 11 11 11 11 11 11 11 11 11 11 11 11 11 11 11 11 11 11 11 11 11 11 11 11 11 11 12 23 23 23 23 24 24 24 23 23 23
23 23 23 23 23 23 23 23 23 20 13 11 11 11 11 11 11 11 11 11 11 11 11 11 11 11 11 11 11 11 11 11 11 11 11 11 11 11 11 11 11 11 11 11 11 11 11 11 11 11 11 11 11 11 11 11 11 11 11 11 11 11 11 11 11 11 11 11 11 11 11 11 11 11 11 11 11 11 11 11 11 11 11 11 11 11 11 11 11 12 23 23 23 23 23 24 24 23 23 23
23 23 23 23 23 23 23 23 23 23 20 13 11 11 11 11 11 11 11 11 11 11 11 11 11 11 11 11 11 11 11 11 11 11 11 11 11 11 11 11 11 11 11 11 11 11 11 11 11 11 11 11 11 11 11 11 11 11 11 11 11 11 11 11 11 11 11 11 11 11 11 11 11 11 11 11 11 11 11 11 11 11 11 11 11 11 11 11 11 12 23 23 23 23 23 24 24 23 23 23
23 23 23 23 23 23 23 23 23 23 23 20 21 13 11 11 11 11 11 11 11 11 11 11 11 11 11 11 11 11 11 11 11 11 11 11 11 11 11 11 11 11 11 11 11 11 11 11 11 11 11 11 11 11 11 11 11 11 11 11 11 11 11 11 11 11 11 11 11 11 11 11 11 11 11 11 11 11 11 11 11 11 11 11 11 11 11 11 11 12 23 23 23 24 24 24 24 23 23 23
23 23 23 23 23 23 23 23 23 23 23 23 23 20 21 21 21 21 21 13 11 11 11 11 11 11 11 11 11 11 11 11 11 11 11 11 11 11 11 11 11 11 11 11 11 11 11 11 11 11 11 11 11 11 11 11 11 11 11 11 11 11 11 11 11 11 11 11 11 11 11 11 11 11 11 11 11 11 11 11 11 11 11 11 11 11 11 11 14 22 23 23 23 24 23 24 24 24 23 23
23 23 23 23 23 23 23 23 23 23 23 23 23 23 23 23 23 23 23 20 21 21 21 13 11 11 11 11 11 11 11 11 11 11 11 11 11 11 11 11 11 11 11 11 11 11 11 11 11 11 11 11 11 11 11 11 11 11 11 11 11 11 11 11 11 11 11 11 11 11 11 11 11 11 11 11 11 11 11 11 11 11 11 11 11 11 14 21 22 23 23 23 23 24 24 24 24 24 23 23
23 23 23 23 23 23 23 23 23 23 23 23 23 23 23 23 23 23 23 23 23 23 23 20 21 21 21 21 13 11 11 11 11 11 11 11 11 11 11 11 11 11 11 11 11 11 11 11 11 11 11 11 11 11 11 11 11 11 11 11 11 11 11 11 11 11 11 11 11 11 11 11 11 11 11 11 11 11 11 11 11 11 11 11 14 21 22 23 23 23 23 23 23 23 23 23 23 23 23 23
23 23 23 23 23 23 23 23 23 23 23 23 23 23 23 23 23 23 23 23 23 23 23 23 23 23 23 23 20 21 21 21 21 21 21 21 21 21 13 11 11 11 11 11 11 14 21 21 21 21 21 21 21 21 21 21 21 21 21 21 21 21 21 21 13 11 11 11 11 11 11 11 11 11 11 14 21 21 21 21 21 21 21 21 22 23 23 23 23 23 23 23 23 23 23 23 23 23 23 23
23 23 23 23 23 23 23 23 23 23 23 23 23 23 23 23 23 23 23 23 23 23 23 23 23 23 23 23 23 23 23 23 23 23 23 23 23 23 20 21 21 21 21 21 21 22 23 23 23 23 23 23 23 23 23 23 23 23 23 23 23 23 23 23 20 21 21 21 21 21 21 21 21 21 21 22 23 23 23 23 23 23 23 23 23 23 23 23 23 23 23 23 23 23 23 23 23 23 23 23
23 23 23 23 23 23 23 23 23 23 23 23 23 23 23 23 23 23 23 23 23 23 23 23 23 23 23 23 23 23 23 23 23 23 23 23 23 23 23 23 23 23 23 23 23 23 23 23 23 23 23 23 23 23 23 23 23 23 23 23 23 23 23 23 23 23 23 23 23 23 23 23 23 23 23 23 23 23 23 23 23 23 23 23 23 23 23 23 23 23 23 23 23 23 23 23 23 23 23 23
